



MOTOBOY PAULINHO:
IGREJA ADVENTISTA DO 7ª DIA REGIÃO NORTE – BAIXO GUANDU/ES

Entrega colatina:
RAFAELA SANTOS – COLATINA/ES – ENDEREÇO NA FICHA!
EDIANA DOS SANTOS(TOTEM) – GOVERNADOR LINDENBERG/ES
PAMELA HELOIZA – ECOPORANGA/ES – ENDEREÇO NA FICHA!

VIAÇÃO PRETTI:
PEGUE MONTE – LINHARES/ES – 14:00!
VIAÇÃO AGUIA BRANCA:
ERICA MORENO – BOA ESPERANÇA/ES – 13:00!
SIMONE MEDEIROS - MANTENA/MG

CORREIOS:
DANIELA FRANCA – SEDEX – SAO MATEUS/ES
JANINE CANDELAS – SEDEX – CONCEICAO DA BARRA/ES
CRISTIANO ALVARENGA – SEDEX – ARACRUZ/ES - JUNTO AS ENCOMENDAS!
JULIANA MAEVE – PAC – OURO PRETO/MG
FABIANA PAZINI  - SEDEX – MARATAIZES/ES
ELISANGELA DE ANDRADE – SEDEX – CACHOEIRO DE ITAPEMIRIM/ES
IRES BASTOS – JUNTO COM O PEDIDO DA SHOPEE – SAO MATEUS/ES


MOTOBOY VIX:
DIEGO RODRIGUES – VIANA/ES
JANAINA CHAVES – VITORIA/ES
ELIANE GALVÃO – VITORIA/ES
DRIELY CORREIA – JOAO NEIVA/ES
MAYARA ALMEIDA – ARACRUZ/ES – JUNTO COM A DRIELY CORREIA!
JONES LUCAS – IBIRAÇU/ES - JUNTO COM A DRIELY CORREIA e MAYARA !
PAMELA MATTIUZZI – IBIRAÇU/ES
BOLHA FEST – VILA VELHA/ES
LEIDIMAR FELISBERTO – VITORIA/ES – JUNTO AS ENCOMENDAS!

RETIRADA:
FERNANDA FOLLI – LINHARES/ES
GIRLIANE MARIA – RETA GRANDE/ES
CARLOS HENRIQUE – COLATINA/ES
ROMULO CANTARELA – BAIXO GUANDU/ES
LARISA SAMUEL – ITARANA/ES – 15:00
DJEISON MILER – PANCAS/ES  - 16:00

A COMBINAR:
ADRIANA LUISA – CENTRAL DE MINAS/MG – VER COM O ANDRÉ
17


CORREIOS:
1ª IGREJA BATISTA EM GUARAPARI - SEDEX - GUARAPARI/ES

RETIRADA:
ANA PAULA – COLATINA/ES

MOTOBOY VIX:
VANESSA PELISSARI - VITORIA/ES